bright aqua: ('light tan',)
bright beige: ('dim silver', 'dull beige')
bright black: ('bright violet', 'dim aqua', 'faded brown')
bright blue: ('clear orange', 'faded yellow', 'vibrant lime', 'wavy gray')
bright bronze: ('shiny turquoise', 'vibrant indigo')
bright brown: ('posh blue', 'shiny brown')
bright chartreuse: ('bright yellow', 'wavy tomato')
bright coral: ('light teal', 'mirrored silver')
bright crimson: ('faded teal', 'mirrored white', 'vibrant beige')
bright cyan: ('light fuchsia', 'light tan', 'mirrored chartreuse')
bright fuchsia: ('absent',)
bright gold: ('faded aqua',)
bright gray: ('dark turquoise', 'light yellow', 'posh teal')
bright green: ('posh tomato', 'wavy red')
bright indigo: ('muted orange', 'striped violet')
bright lavender: ('dotted purple', 'faded black', 'light purple')
bright lime: ('faded beige', 'shiny coral', 'vibrant plum', 'wavy fuchsia')
bright magenta: ('bright fuchsia', 'bright lavender', 'clear yellow', 'dim crimson')
bright maroon: ('clear maroon', 'faded brown', 'faded crimson')
bright olive: ('dull violet', 'striped black', 'vibrant orange')
bright orange: ('clear orange', 'faded white', 'vibrant salmon', 'vibrant yellow')
bright plum: ('vibrant teal',)
bright purple: ('dull olive', 'faded violet', 'muted gold')
bright red: ('pale coral',)
bright salmon: ('bright crimson', 'muted tomato')
bright silver: ('vibrant salmon', 'wavy white')
bright tan: ('clear green', 'light violet', 'shiny tan')
bright teal: ('striped plum',)
bright tomato: ('striped black',)
bright turquoise: ('wavy yellow',)
bright violet: ('clear white', 'plaid beige')
bright white: ('bright crimson', 'pale fuchsia', 'pale teal', 'posh white')
bright yellow: ('clear indigo', 'clear turquoise', 'dotted gray')
clear aqua: ('dull bronze', 'shiny bronze')
clear beige: ('clear white', 'faded violet', 'plaid indigo', 'wavy indigo')
clear black: ('bright magenta', 'faded yellow', 'plaid aqua', 'striped blue')
clear blue: ('dotted green', 'drab crimson', 'wavy tomato')
clear bronze: ('faded brown', 'posh green', 'shiny violet')
clear brown: ('dim plum', 'light lavender', 'shiny gray')
clear chartreuse: ('dotted turquoise',)
clear coral: ('dark maroon', 'light orange', 'striped tomato')
clear crimson: ('mirrored silver',)
clear cyan: ('drab cyan',)
clear fuchsia: ('bright brown',)
clear gold: ('faded coral', 'plaid black')
clear gray: ('dull orange', 'light fuchsia', 'shiny gold', 'vibrant beige')
clear green: ('bright fuchsia', 'dim maroon', 'muted crimson', 'shiny blue')
clear indigo: ('wavy indigo',)
clear lavender: ('dark plum', 'dim salmon', 'mirrored magenta', 'plaid silver')
clear lime: ('mirrored gold', 'wavy coral')
clear magenta: ('clear indigo',)
clear maroon: ('absent',)
clear olive: ('dim bronze', 'faded teal', 'vibrant orange')
clear orange: ('dotted purple', 'plaid fuchsia', 'shiny lime')
clear plum: ('absent',)
clear purple: ('faded indigo', 'muted purple')
clear red: ('bright turquoise', 'clear crimson', 'clear green')
clear salmon: ('drab yellow', 'light lime', 'muted black', 'vibrant magenta')
clear silver: ('faded crimson', 'mirrored chartreuse', 'striped coral', 'vibrant magenta')
clear tan: ('dim plum', 'vibrant purple')
clear teal: ('dark aqua', 'mirrored salmon')
clear tomato: ('bright beige', 'mirrored crimson', 'pale coral', 'posh aqua')
clear turquoise: ('bright coral', 'drab cyan')
clear violet: ('plaid chartreuse',)
clear white: ('posh tomato', 'vibrant aqua', 'vibrant teal')
clear yellow: ('clear plum', 'light tomato', 'shiny violet', 'wavy indigo')
dark aqua: ('absent',)
dark beige: ('pale turquoise',)
dark black: ('bright orange', 'light black', 'posh lavender')
dark blue: ('vibrant indigo',)
dark bronze: ('clear plum', 'shiny violet')
dark brown: ('striped cyan', 'vibrant yellow')
dark chartreuse: ('dotted brown', 'vibrant magenta')
dark coral: ('dotted fuchsia',)
dark crimson: ('dark fuchsia', 'striped blue')
dark cyan: ('dark olive', 'dim maroon', 'dim plum', 'light purple')
dark fuchsia: ('dotted fuchsia', 'dull red')
dark gold: ('dotted beige', 'pale cyan', 'vibrant magenta', 'vibrant teal')
dark gray: ('clear gray', 'dim turquoise')
dark green: ('dim crimson', 'faded aqua', 'pale beige', 'vibrant aqua')
dark indigo: ('mirrored magenta',)
dark lavender: ('dark brown', 'dark turquoise', 'dotted gold')
dark lime: ('drab green', 'light crimson')
dark magenta: ('posh white', 'shiny aqua')
dark maroon: ('light tomato', 'mirrored purple')
dark olive: ('bright magenta', 'drab magenta', 'plaid crimson')
dark orange: ('faded violet', 'light violet', 'shiny coral')
dark plum: ('dull aqua', 'faded red')
dark purple: ('wavy yellow',)
dark red: ('plaid salmon', 'striped magenta')
dark salmon: ('posh fuchsia',)
dark silver: ('bright cyan', 'pale plum', 'wavy aqua')
dark tan: ('bright coral', 'posh green', 'wavy salmon')
dark teal: ('dark tan', 'posh chartreuse')
dark tomato: ('dull violet', 'muted brown', 'vibrant magenta')
dark turquoise: ('clear yellow', 'muted brown', 'wavy maroon')
dark violet: ('dull violet', 'pale green', 'wavy tomato')
dark white: ('clear white', 'dark crimson', 'dull bronze', 'dull chartreuse')
dark yellow: ('pale lime', 'pale red', 'plaid orange')
dim aqua: ('clear white', 'light lime', 'posh green')
dim beige: ('dim black', 'shiny blue')
dim black: ('light beige', 'plaid cyan', 'posh yellow', 'vibrant cyan')
dim blue: ('clear orange', 'clear teal', 'clear turquoise')
dim bronze: ('striped blue',)
dim brown: ('clear bronze', 'dark olive', 'striped orange')
dim chartreuse: ('clear bronze',)
dim coral: ('dim white', 'drab maroon', 'plaid crimson', 'striped violet')
dim crimson: ('faded tomato', 'light tomato', 'muted crimson', 'plaid bronze')
dim cyan: ('muted brown', 'posh magenta')
dim fuchsia: ('dotted purple', 'plaid indigo', 'vibrant tomato')
dim gold: ('dull orange',)
dim gray: ('faded tomato',)
dim green: ('pale turquoise',)
dim indigo: ('dotted gold', 'muted coral', 'posh plum')
dim lavender: ('dotted tan', 'dull maroon', 'light purple', 'striped plum')
dim lime: ('posh teal',)
dim magenta: ('dark olive', 'dark tan', 'shiny indigo', 'shiny turquoise')
dim maroon: ('absent',)
dim olive: ('faded brown', 'faded crimson', 'plaid teal')
dim orange: ('muted lime',)
dim plum: ('bright fuchsia', 'wavy yellow')
dim purple: ('clear orange', 'drab crimson', 'pale aqua')
dim red: ('clear silver',)
dim salmon: ('dim magenta', 'plaid fuchsia', 'vibrant magenta', 'wavy fuchsia')
dim silver: ('bright fuchsia',)
dim tan: ('pale plum',)
dim teal: ('drab gold',)
dim tomato: ('drab lime', 'vibrant tomato')
dim turquoise: ('light yellow', 'plaid silver', 'shiny orange', 'striped cyan')
dim violet: ('drab chartreuse', 'pale lavender', 'shiny gold')
dim white: ('light yellow', 'mirrored blue', 'plaid coral', 'vibrant cyan')
dim yellow: ('bright fuchsia', 'dark blue', 'drab tan')
dotted aqua: ('dotted coral', 'faded maroon')
dotted beige: ('light violet',)
dotted black: ('mirrored lime',)
dotted blue: ('vibrant tan',)
dotted bronze: ('dim plum', 'mirrored crimson', 'mirrored lime', 'posh gray')
dotted brown: ('absent',)
dotted chartreuse: ('light salmon',)
dotted coral: ('bright maroon', 'drab tomato', 'mirrored magenta')
dotted crimson: ('dull violet', 'muted gold', 'muted teal')
dotted cyan: ('clear bronze', 'dull orange', 'posh gray')
dotted fuchsia: ('faded aqua', 'posh green')
dotted gold: ('dim purple', 'posh violet', 'shiny tomato')
dotted gray: ('faded black', 'pale tomato')
dotted green: ('clear crimson', 'dim gray', 'dotted maroon', 'plaid green')
dotted indigo: ('bright coral', 'plaid purple')
dotted lavender: ('clear indigo',)
dotted lime: ('faded red', 'mirrored magenta')
dotted magenta: ('clear maroon', 'plaid gold')
dotted maroon: ('bright fuchsia', 'faded brown', 'wavy yellow')
dotted olive: ('muted plum', 'pale plum')
dotted orange: ('plaid chartreuse', 'posh teal', 'vibrant purple')
dotted plum: ('bright turquoise', 'drab maroon', 'light gray')
dotted purple: ('dim maroon',)
dotted red: ('dim plum',)
dotted salmon: ('muted purple', 'striped coral')
dotted silver: ('dotted indigo', 'faded chartreuse', 'wavy white')
dotted tan: ('clear teal', 'dim lime', 'dotted crimson', 'light purple')
dotted teal: ('dim teal', 'striped fuchsia')
dotted tomato: ('dotted crimson', 'wavy coral')
dotted turquoise: ('clear gray', 'vibrant plum', 'wavy yellow')
dotted violet: ('clear bronze', 'faded brown', 'faded tomato', 'shiny gold')
dotted white: ('plaid teal', 'shiny indigo')
dotted yellow: ('light bronze', 'mirrored tomato', 'shiny green')
drab aqua: ('dotted purple', 'vibrant crimson', 'vibrant tan')
drab beige: ('wavy aqua',)
drab black: ('dull maroon', 'muted crimson', 'posh green', 'wavy brown')
drab blue: ('plaid tomato', 'striped purple')
drab bronze: ('clear maroon', 'posh turquoise', 'striped fuchsia', 'vibrant coral')
drab brown: ('dotted yellow', 'faded aqua', 'striped gold', 'wavy maroon')
drab chartreuse: ('clear beige', 'drab olive', 'muted green')
drab coral: ('vibrant beige',)
drab crimson: ('dim gray', 'posh aqua')
drab cyan: ('light green', 'pale teal')
drab fuchsia: ('bright turquoise', 'clear white', 'muted purple', 'striped lime')
drab gold: ('dim crimson', 'drab magenta', 'faded tomato')
drab gray: ('dim lime', 'dotted maroon', 'mirrored brown', 'shiny fuchsia')
drab green: ('light tan', 'plaid tomato')
drab indigo: ('dotted turquoise',)
drab lavender: ('dotted beige', 'dull tomato', 'light gray')
drab lime: ('dotted maroon', 'pale bronze', 'striped black')
drab magenta: ('dark aqua', 'dotted brown', 'muted crimson', 'wavy indigo')
drab maroon: ('clear plum', 'shiny coral')
drab olive: ('wavy salmon',)
drab orange: ('dull tomato', 'mirrored tan', 'striped gold', 'wavy aqua')
drab plum: ('pale chartreuse', 'wavy crimson')
drab purple: ('wavy orange',)
drab red: ('dotted plum', 'dotted tomato', 'drab orange', 'wavy teal')
drab salmon: ('clear yellow', 'faded silver', 'muted white')
drab silver: ('bright crimson', 'dim plum', 'dull teal', 'wavy yellow')
drab tan: ('dull white', 'light tomato', 'muted tan', 'shiny blue')
drab teal: ('bright coral', 'dull purple', 'faded fuchsia', 'mirrored maroon')
drab tomato: ('clear plum', 'clear red', 'posh teal', 'wavy aqua')
drab turquoise: ('bright maroon', 'dim gray', 'muted silver')
drab violet: ('dim bronze', 'light violet', 'striped lavender', 'vibrant tomato')
drab white: ('muted olive', 'plaid tan', 'posh magenta')
drab yellow: ('light purple', 'posh salmon', 'striped orange')
dull aqua: ('shiny blue',)
dull beige: ('posh aqua',)
dull black: ('dull chartreuse', 'plaid bronze', 'shiny brown', 'wavy teal')
dull blue: ('light silver',)
dull bronze: ('dark olive', 'dull white')
dull brown: ('dotted lime', 'dull plum', 'dull white', 'faded brown')
dull chartreuse: ('clear chartreuse', 'dull orange')
dull coral: ('dotted green', 'dull orange')
dull crimson: ('muted brown', 'muted red')
dull cyan: ('bright coral', 'dark olive', 'muted coral', 'plaid orange')
dull fuchsia: ('dark purple', 'light red', 'pale turquoise')
dull gold: ('light beige', 'mirrored gold', 'vibrant purple')
dull gray: ('posh fuchsia',)
dull green: ('dotted coral', 'dotted orange', 'faded beige', 'pale tan')
dull indigo: ('dull plum', 'posh green', 'posh white', 'shiny black')
dull lavender: ('clear teal',)
dull lime: ('bright plum', 'pale bronze', 'plaid black')
dull magenta: ('faded black', 'light white', 'mirrored blue', 'shiny coral')
dull maroon: ('striped plum',)
dull olive: ('clear turquoise', 'drab green', 'pale cyan')
dull orange: ('bright turquoise', 'dotted purple', 'drab gold', 'plaid bronze')
dull plum: ('mirrored salmon',)
dull purple: ('pale lime', 'posh lime', 'striped red', 'wavy olive')
dull red: ('clear beige', 'wavy tomato')
dull salmon: ('dotted maroon', 'dull maroon', 'striped gold')
dull silver: ('clear chartreuse', 'pale salmon', 'posh cyan', 'shiny lavender')
dull tan: ('faded indigo', 'light cyan', 'shiny turquoise')
dull teal: ('wavy yellow',)
dull tomato: ('mirrored salmon',)
dull turquoise: ('plaid coral',)
dull violet: ('bright lavender', 'shiny coral')
dull white: ('light teal',)
dull yellow: ('dark beige', 'faded bronze', 'plaid black', 'posh salmon')
faded aqua: ('bright fuchsia', 'dotted violet', 'shiny gold')
faded beige: ('bright teal', 'faded crimson', 'plaid teal')
faded black: ('bright fuchsia', 'dim plum', 'drab magenta')
faded blue: ('plaid green',)
faded bronze: ('shiny blue',)
faded brown: ('clear maroon',)
faded chartreuse: ('dull tomato', 'mirrored salmon')
faded coral: ('mirrored beige', 'vibrant maroon')
faded crimson: ('faded brown',)
faded cyan: ('dotted lavender', 'mirrored plum', 'muted lime', 'plaid olive')
faded fuchsia: ('clear red',)
faded gold: ('light lime', 'shiny indigo')
faded gray: ('posh teal', 'striped maroon', 'vibrant tomato')
faded green: ('vibrant black',)
faded indigo: ('bright bronze', 'dim lime')
faded lavender: ('drab maroon', 'posh bronze', 'vibrant violet', 'wavy bronze')
faded lime: ('dim lavender', 'faded yellow')
faded magenta: ('bright blue',)
faded maroon: ('clear olive', 'dull maroon', 'light indigo', 'wavy beige')
faded olive: ('bright bronze', 'dotted violet', 'vibrant purple')
faded orange: ('clear plum', 'faded maroon')
faded plum: ('dim brown', 'light turquoise', 'posh chartreuse', 'shiny turquoise')
faded purple: ('shiny aqua', 'vibrant cyan')
faded red: ('striped maroon',)
faded salmon: ('drab white', 'plaid brown', 'wavy olive')
faded silver: ('faded brown', 'muted brown')
faded tan: ('pale bronze',)
faded teal: ('posh crimson', 'vibrant beige')
faded tomato: ('muted crimson', 'plaid cyan', 'vibrant magenta')
faded turquoise: ('plaid chartreuse', 'posh yellow')
faded violet: ('plaid indigo',)
faded white: ('plaid olive',)
faded yellow: ('light tomato', 'plaid tomato')
light aqua: ('dull fuchsia', 'posh orange')
light beige: ('dotted turquoise', 'pale cyan')
light black: ('clear plum', 'faded olive')
light blue: ('bright tan', 'clear black', 'dotted teal', 'dull magenta')
light bronze: ('light purple',)
light brown: ('light green', 'shiny orange')
light chartreuse: ('shiny coral', 'shiny purple')
light coral: ('bright magenta', 'wavy brown')
light crimson: ('dim gray',)
light cyan: ('drab maroon', 'dull tomato', 'vibrant indigo', 'wavy gray')
light fuchsia: ('clear maroon', 'dotted brown')
light gold: ('plaid chartreuse', 'plaid tan')
light gray: ('drab magenta',)
light green: ('dark orange', 'drab magenta')
light indigo: ('dark aqua',)
light lavender: ('dim lime', 'faded brown', 'faded chartreuse')
light lime: ('bright fuchsia', 'bright olive')
light magenta: ('clear beige', 'light indigo', 'shiny lime')
light maroon: ('dark orange', 'drab plum', 'vibrant maroon')
light olive: ('mirrored lime', 'pale lime')
light orange: ('clear plum', 'light tomato')
light plum: ('light indigo', 'posh gold')
light purple: ('clear green', 'dull aqua', 'light fuchsia', 'light gray')
light red: ('drab chartreuse', 'muted silver', 'wavy cyan')
light salmon: ('faded red', 'mirrored yellow', 'muted coral', 'muted silver')
light silver: ('clear black', 'pale plum', 'pale red')
light tan: ('dotted tan',)
light teal: ('bright turquoise', 'clear green', 'clear yellow', 'light violet')
light tomato: ('absent',)
light turquoise: ('dotted violet', 'shiny cyan', 'shiny lime', 'vibrant tan')
light violet: ('bright turquoise', 'faded teal', 'light gray', 'posh crimson')
light white: ('clear white', 'posh lavender', 'vibrant white')
light yellow: ('vibrant black',)
mirrored aqua: ('dim chartreuse', 'mirrored magenta', 'plaid tomato', 'posh aqua')
mirrored beige: ('faded bronze',)
mirrored black: ('striped gray',)
mirrored blue: ('bright crimson', 'dark olive', 'light salmon')
mirrored bronze: ('clear bronze', 'drab blue', 'drab white')
mirrored brown: ('clear plum',)
mirrored chartreuse: ('dotted violet', 'faded brown')
mirrored coral: ('clear teal', 'muted crimson', 'plaid gold', 'wavy teal')
mirrored crimson: ('drab chartreuse', 'muted gray')
mirrored cyan: ('drab gray',)
mirrored fuchsia: ('clear tan', 'drab bronze', 'pale indigo', 'vibrant coral')
mirrored gold: ('clear orange', 'mirrored aqua', 'shiny black', 'shiny coral')
mirrored gray: ('dark tan', 'pale beige', 'shiny coral')
mirrored green: ('dull turquoise', 'mirrored crimson')
mirrored indigo: ('bright coral', 'dull fuchsia', 'wavy indigo')
mirrored lavender: ('bright violet', 'dull turquoise', 'faded bronze')
mirrored lime: ('plaid purple',)
mirrored magenta: ('vibrant black', 'vibrant plum')
mirrored maroon: ('drab coral',)
mirrored olive: ('bright orange', 'dim silver', 'striped crimson', 'wavy tan')
mirrored orange: ('posh white',)
mirrored plum: ('drab aqua', 'striped gold')
mirrored purple: ('dotted teal', 'drab black')
mirrored red: ('bright tan', 'faded white', 'wavy lime')
mirrored salmon: ('clear plum', 'dim crimson', 'striped plum')
mirrored silver: ('clear maroon', 'clear plum', 'dotted maroon', 'shiny blue')
mirrored tan: ('muted olive', 'pale turquoise', 'shiny violet')
mirrored teal: ('muted green', 'plaid magenta', 'vibrant crimson', 'wavy brown')
mirrored tomato: ('dotted brown', 'posh magenta', 'wavy green')
mirrored turquoise: ('light lavender', 'wavy red', 'wavy turquoise')
mirrored violet: ('clear white', 'shiny black')
mirrored white: ('drab magenta', 'faded tomato', 'plaid cyan')
mirrored yellow: ('wavy brown',)
muted aqua: ('drab tan', 'muted purple', 'shiny magenta')
muted beige: ('dull fuchsia', 'vibrant tomato')
muted black: ('wavy orange',)
muted blue: ('pale cyan', 'posh teal')
muted bronze: ('dull aqua', 'striped turquoise')
muted brown: ('posh gray',)
muted chartreuse: ('dotted fuchsia', 'dull salmon', 'light teal')
muted coral: ('dim plum', 'plaid cyan', 'wavy salmon')
muted crimson: ('absent',)
muted cyan: ('dark cyan', 'dull aqua')
muted fuchsia: ('pale cyan',)
muted gold: ('faded crimson', 'vibrant teal')
muted gray: ('bright teal', 'light yellow', 'mirrored brown', 'posh teal')
muted green: ('clear maroon', 'dull orange')
muted indigo: ('dim gold', 'dotted olive', 'dull turquoise')
muted lavender: ('wavy cyan',)
muted lime: ('dim olive', 'pale fuchsia')
muted magenta: ('clear fuchsia', 'plaid cyan', 'shiny crimson', 'shiny gold')
muted maroon: ('dotted maroon', 'drab yellow', 'pale crimson', 'posh aqua')
muted olive: ('faded brown', 'faded teal', 'muted gold', 'vibrant orange')
muted orange: ('bright gold', 'bright tan', 'shiny teal')
muted plum: ('clear maroon',)
muted purple: ('shiny turquoise',)
muted red: ('clear bronze', 'dim plum')
muted salmon: ('dim tomato', 'faded yellow', 'pale orange')
muted silver: ('muted coral',)
muted tan: ('dotted beige', 'dull cyan', 'pale beige', 'striped gold')
muted teal: ('clear red', 'vibrant aqua', 'vibrant magenta')
muted tomato: ('dark violet', 'pale gray', 'posh aqua', 'wavy red')
muted turquoise: ('bright red', 'clear cyan', 'dull gold', 'light tomato')
muted violet: ('dotted bronze', 'drab white', 'muted silver')
muted white: ('striped turquoise',)
muted yellow: ('dim cyan', 'dotted aqua')
pale aqua: ('dim gold', 'pale green', 'shiny tomato')
pale beige: ('wavy salmon',)
pale black: ('mirrored yellow', 'wavy brown')
pale blue: ('pale lavender',)
pale bronze: ('faded crimson', 'pale coral', 'vibrant tan')
pale brown: ('dull coral',)
pale chartreuse: ('muted gold', 'plaid orange', 'vibrant beige')
pale coral: ('vibrant beige',)
pale crimson: ('dotted tan',)
pale cyan: ('dotted green', 'drab maroon')
pale fuchsia: ('mirrored orange',)
pale gold: ('mirrored chartreuse', 'posh silver')
pale gray: ('dotted fuchsia', 'pale salmon')
pale green: ('bright beige', 'dim lime', 'mirrored silver', 'posh turquoise')
pale indigo: ('shiny aqua', 'striped lime', 'wavy black')
pale lavender: ('drab magenta', 'light green')
pale lime: ('posh gold', 'shiny indigo', 'striped blue')
pale magenta: ('bright fuchsia',)
pale maroon: ('bright coral', 'dim maroon', 'dull aqua', 'vibrant magenta')
pale olive: ('bright lime', 'drab brown', 'muted blue', 'vibrant lime')
pale orange: ('plaid yellow', 'posh indigo')
pale plum: ('dull crimson', 'striped cyan', 'vibrant orange')
pale purple: ('light turquoise', 'striped black')
pale red: ('mirrored silver', 'shiny coral', 'shiny turquoise')
pale salmon: ('dim lime',)
pale silver: ('mirrored turquoise',)
pale tan: ('dotted purple', 'mirrored yellow', 'pale red', 'vibrant white')
pale teal: ('clear green',)
pale tomato: ('dull cyan', 'faded beige')
pale turquoise: ('dark bronze', 'dotted violet', 'light tomato', 'muted gold')
pale violet: ('drab indigo',)
pale white: ('pale indigo',)
pale yellow: ('clear gray', 'dotted maroon', 'dull cyan', 'light teal')
plaid aqua: ('drab gold', 'faded tomato', 'plaid cyan')
plaid beige: ('dull aqua', 'faded white', 'muted crimson')
plaid black: ('faded aqua',)
plaid blue: ('faded red', 'light fuchsia', 'shiny tomato', 'vibrant tomato')
plaid bronze: ('absent',)
plaid brown: ('dark orange', 'pale bronze', 'shiny salmon')
plaid chartreuse: ('dark bronze', 'dark tan', 'dotted crimson', 'drab tomato')
plaid coral: ('dark olive',)
plaid crimson: ('faded black',)
plaid cyan: ('bright fuchsia', 'clear maroon', 'dark aqua', 'plaid bronze')
plaid fuchsia: ('dim bronze', 'dotted beige', 'vibrant crimson', 'wavy gray')
plaid gold: ('striped maroon',)
plaid gray: ('dim yellow', 'faded lime')
plaid green: ('pale bronze',)
plaid indigo: ('bright fuchsia', 'dark aqua', 'wavy indigo')
plaid lavender: ('striped lime',)
plaid lime: ('dim aqua', 'dull magenta', 'wavy gray', 'wavy yellow')
plaid magenta: ('plaid beige', 'posh teal')
plaid maroon: ('clear white',)
plaid olive: ('clear gray', 'dotted tan')
plaid orange: ('dark orange', 'plaid bronze')
plaid plum: ('dark cyan',)
plaid purple: ('dotted maroon', 'shiny turquoise')
plaid red: ('plaid silver',)
plaid salmon: ('bright black',)
plaid silver: ('drab aqua', 'plaid crimson', 'striped orange')
plaid tan: ('dark orange', 'dotted tan')
plaid teal: ('clear green', 'dull orange', 'plaid crimson', 'shiny gold')
plaid tomato: ('bright coral', 'clear teal')
plaid turquoise: ('clear teal', 'light lavender', 'light teal', 'posh salmon')
plaid violet: ('faded beige', 'muted gold', 'posh brown')
plaid white: ('dotted cyan',)
plaid yellow: ('plaid white', 'striped brown', 'vibrant indigo')
posh aqua: ('bright plum', 'dotted green', 'vibrant orange')
posh beige: ('clear lime', 'pale maroon', 'shiny teal')
posh black: ('muted olive', 'striped turquoise', 'wavy crimson')
posh blue: ('light cyan', 'striped beige', 'wavy fuchsia')
posh bronze: ('bright bronze', 'dotted lime', 'dotted maroon', 'wavy tomato')
posh brown: ('bright fuchsia', 'posh magenta', 'vibrant plum')
posh chartreuse: ('plaid cyan', 'posh cyan')
posh coral: ('drab gray', 'striped red')
posh crimson: ('dark aqua', 'dull aqua', 'posh teal')
posh cyan: ('dotted violet',)
posh fuchsia: ('drab gray', 'faded bronze')
posh gold: ('drab chartreuse',)
posh gray: ('posh tomato',)
posh green: ('dim maroon', 'faded black', 'wavy yellow')
posh indigo: ('muted blue',)
posh lavender: ('dark blue', 'plaid violet', 'vibrant black', 'wavy teal')
posh lime: ('light indigo', 'muted tan', 'shiny coral')
posh magenta: ('dim gray',)
posh maroon: ('dim black', 'dim olive', 'muted olive', 'plaid cyan')
posh olive: ('pale bronze',)
posh orange: ('light green', 'shiny lime', 'vibrant white')
posh plum: ('drab maroon', 'light tomato', 'plaid tomato', 'vibrant purple')
posh purple: ('plaid turquoise', 'shiny purple')
posh red: ('faded blue', 'mirrored green')
posh salmon: ('shiny coral', 'wavy maroon')
posh silver: ('wavy black',)
posh tan: ('clear salmon',)
posh teal: ('clear plum', 'dim crimson', 'faded black')
posh tomato: ('clear plum', 'dull orange')
posh turquoise: ('posh crimson',)
posh violet: ('light green', 'pale teal')
posh white: ('clear teal', 'shiny cyan')
posh yellow: ('plaid teal',)
shiny aqua: ('dotted brown',)
shiny beige: ('dull teal', 'mirrored magenta', 'striped lavender', 'vibrant indigo')
shiny black: ('faded yellow',)
shiny blue: ('plaid bronze',)
shiny bronze: ('clear teal', 'muted coral', 'vibrant magenta')
shiny brown: ('dotted maroon', 'muted olive', 'posh black', 'shiny coral')
shiny chartreuse: ('dull maroon', 'plaid aqua', 'striped black', 'striped tomato')
shiny coral: ('bright turquoise', 'wavy yellow')
shiny crimson: ('faded red',)
shiny cyan: ('clear plum', 'posh gray', 'shiny aqua', 'shiny coral')
shiny fuchsia: ('wavy crimson',)
shiny gold: ('bright fuchsia', 'clear plum', 'light violet', 'plaid bronze')
shiny gray: ('drab chartreuse', 'mirrored crimson')
shiny green: ('mirrored cyan',)
shiny indigo: ('plaid teal',)
shiny lavender: ('bright yellow', 'light coral', 'pale purple', 'plaid purple')
shiny lime: ('faded bronze', 'mirrored white', 'shiny turquoise', 'vibrant white')
shiny magenta: ('dark purple', 'dotted green', 'shiny tomato')
shiny maroon: ('bright tan', 'dotted coral', 'wavy crimson')
shiny olive: ('mirrored turquoise', 'muted olive', 'plaid magenta')
shiny orange: ('dim lime', 'dull indigo', 'plaid lavender')
shiny plum: ('light indigo', 'muted plum')
shiny purple: ('dark purple', 'dull magenta', 'plaid fuchsia')
shiny red: ('faded black', 'faded tomato', 'muted bronze', 'pale teal')
shiny salmon: ('dim bronze', 'muted olive', 'vibrant tomato')
shiny silver: ('muted maroon', 'pale purple')
shiny tan: ('plaid tan', 'wavy green', 'wavy red')
shiny teal: ('drab lime', 'shiny tan', 'striped salmon')
shiny tomato: ('dim crimson',)
shiny turquoise: ('bright turquoise',)
shiny violet: ('plaid cyan', 'striped plum')
shiny white: ('wavy purple',)
shiny yellow: ('bright magenta',)
striped aqua: ('dotted violet', 'drab magenta', 'pale magenta')
striped beige: ('vibrant beige',)
striped black: ('dark orange', 'faded red')
striped blue: ('dotted purple', 'faded tomato')
striped bronze: ('dim red', 'vibrant maroon', 'vibrant silver')
striped brown: ('shiny indigo', 'vibrant black')
striped chartreuse: ('dim chartreuse', 'pale cyan')
striped coral: ('shiny coral',)
striped crimson: ('pale bronze', 'pale coral', 'striped blue', 'vibrant white')
striped cyan: ('bright bronze', 'dim teal', 'drab chartreuse', 'posh salmon')
striped fuchsia: ('dim plum', 'dull teal', 'faded gray', 'pale turquoise')
striped gold: ('faded teal', 'vibrant plum')
striped gray: ('mirrored gold',)
striped green: ('faded gray', 'pale green', 'posh blue')
striped indigo: ('vibrant magenta',)
striped lavender: ('dull orange',)
striped lime: ('dotted red', 'muted coral', 'shiny gold')
striped magenta: ('dark orange',)
striped maroon: ('dotted beige', 'light tomato')
striped olive: ('bright crimson', 'dim olive', 'dull orange', 'pale coral')
striped orange: ('dark bronze', 'striped red')
striped plum: ('dim plum', 'faded black', 'faded brown')
striped purple: ('dark bronze', 'mirrored white', 'vibrant tomato')
striped red: ('clear crimson', 'dotted green', 'plaid olive')
striped salmon: ('dark fuchsia', 'shiny chartreuse')
striped silver: ('clear yellow', 'dotted green')
striped tan: ('pale lime',)
striped teal: ('clear maroon', 'drab crimson', 'muted blue', 'posh green')
striped tomato: ('bright violet', 'faded white', 'plaid aqua', 'shiny beige')
striped turquoise: ('shiny gold', 'shiny turquoise')
striped violet: ('dim lime', 'shiny gray')
striped white: ('dull beige',)
striped yellow: ('clear black', 'mirrored orange', 'pale magenta')
vibrant aqua: ('light gray', 'light tomato', 'posh tomato', 'vibrant white')
vibrant beige: ('bright turquoise', 'dim maroon', 'dim plum', 'drab magenta')
vibrant black: ('bright coral', 'dotted purple')
vibrant blue: ('clear indigo', 'dark crimson', 'pale lime')
vibrant bronze: ('dotted beige', 'dull crimson', 'faded purple', 'mirrored turquoise')
vibrant brown: ('pale magenta', 'posh violet')
vibrant chartreuse: ('faded violet',)
vibrant coral: ('clear bronze', 'striped brown')
vibrant crimson: ('faded brown', 'pale chartreuse')
vibrant cyan: ('wavy brown',)
vibrant fuchsia: ('mirrored white',)
vibrant gold: ('bright olive', 'plaid purple', 'vibrant yellow')
vibrant gray: ('dotted teal', 'plaid orange')
vibrant green: ('dull aqua', 'posh cyan')
vibrant indigo: ('bright turquoise',)
vibrant lavender: ('pale black',)
vibrant lime: ('light lavender', 'mirrored tomato')
vibrant magenta: ('clear maroon', 'plaid bronze', 'wavy indigo')
vibrant maroon: ('mirrored brown', 'shiny coral')
vibrant olive: ('drab aqua', 'posh coral')
vibrant orange: ('striped plum',)
vibrant plum: ('dim maroon', 'plaid bronze', 'wavy yellow')
vibrant purple: ('light gray', 'posh aqua')
vibrant red: ('dim aqua', 'plaid green')
vibrant salmon: ('bright olive', 'light turquoise', 'mirrored white', 'striped maroon')
vibrant silver: ('clear violet', 'drab orange', 'plaid magenta', 'shiny violet')
vibrant tan: ('clear bronze', 'light teal', 'vibrant tomato')
vibrant teal: ('shiny violet',)
vibrant tomato: ('dotted brown', 'mirrored silver', 'posh tomato')
vibrant turquoise: ('faded bronze', 'posh tomato')
vibrant violet: ('bright brown', 'dim brown', 'pale coral', 'wavy plum')
vibrant white: ('dotted purple', 'dull aqua', 'faded teal', 'faded tomato')
vibrant yellow: ('dotted brown', 'striped plum', 'vibrant brown', 'wavy green')
wavy aqua: ('drab gold', 'wavy yellow')
wavy beige: ('bright white', 'dark beige', 'mirrored white', 'pale tomato')
wavy black: ('bright magenta', 'clear indigo', 'dotted purple', 'posh violet')
wavy blue: ('pale chartreuse', 'shiny brown')
wavy bronze: ('dim plum', 'drab green', 'mirrored lavender')
wavy brown: ('clear yellow', 'dim silver', 'mirrored white')
wavy chartreuse: ('clear maroon', 'muted crimson', 'striped magenta')
wavy coral: ('clear maroon', 'dotted tan')
wavy crimson: ('pale coral',)
wavy cyan: ('posh crimson', 'vibrant magenta')
wavy fuchsia: ('dull maroon', 'faded lime', 'vibrant magenta')
wavy gold: ('dim lime', 'drab white', 'plaid tomato', 'wavy salmon')
wavy gray: ('shiny blue',)
wavy green: ('light teal', 'mirrored salmon', 'muted crimson', 'vibrant plum')
wavy indigo: ('absent',)
wavy lavender: ('bright white', 'pale gray', 'wavy white')
wavy lime: ('drab orange',)
wavy magenta: ('bright tan', 'posh brown', 'vibrant tan')
wavy maroon: ('light teal', 'mirrored salmon', 'muted olive', 'posh gray')
wavy olive: ('mirrored tomato', 'wavy cyan')
wavy orange: ('pale salmon', 'plaid aqua')
wavy plum: ('bright lavender', 'dark plum', 'pale brown')
wavy purple: ('dim lavender', 'dotted fuchsia', 'posh yellow', 'striped red')
wavy red: ('dim crimson', 'plaid cyan')
wavy salmon: ('clear maroon',)
wavy silver: ('drab magenta', 'faded tan', 'mirrored chartreuse', 'vibrant yellow')
wavy tan: ('dim silver', 'plaid magenta', 'shiny cyan', 'striped gold')
wavy teal: ('drab tan',)
wavy tomato: ('dull aqua', 'light tan', 'pale black', 'striped plum')
wavy turquoise: ('dull salmon', 'mirrored cyan', 'mirrored magenta', 'vibrant tomato')
wavy violet: ('clear white', 'posh coral')
wavy white: ('mirrored brown', 'muted red', 'plaid tomato', 'wavy indigo')
wavy yellow: ('light tomato',)
